5 5 1
@@@@@@
@w...@
@..@.@
@.@..@
@@@..@
@.$.@@
@@@@@@